###############
#P   C        #
#   ##        #
#          C  #
#           ###
#  ###        #
#           ###
#          E  #
###############
