###############
#P   C        #
#   ##   #    #
#        # C  #
#        ######
#             #
#     #########
#          E  #
###############
